1,3,2,9,1,3,2,9,2
2,5,4,2,1,3,2,3,2
3,2,8,1,1,3,2,2,2
3,1,6,1,1,2,2,1,2
3,9,6,1,1,5,2,0,2
3,9,6,2,1,0,1,9,2
5,1,6,0,1,3,4,1,0
4,1,6,5,1,5,4,1,100
3,2,6,6,1,2,2,1,0