1,3,2,9,1
2,5,4,2,1
3,2,8,1,1
3,1,6,1,1
3,9,6,1,1